-14
14
-13
-13
1111111111111111111111111111
1222221000000000000001222221
1222221000000000000001222221
1222221000000000000002222221
1222221000000000000002222221
1112211000000000000001111111
1000000000000000000000000001
1000000000000000000000000001
1000000000000000000000000001
1000000000000000000000000001
1000000000000000000000000001
1000000000000000000000000001
1000000000000000000000000001
1000000000000000000000000001
1000000000000000000000000001
1000000000000000000000000001
1000000000000000000000000001
1000000000000000000000000001
1000000000000000000000000001
1000000000000000000000000001
1111111000000000000001122111
1222221000000000000001222221
1222222000000000000001222221
1222222000000000000001222221
1222221000000000000001222221
1111111111111111111111111111
